difficulty:85
map
  ##########
###   .    #
#   ##$##  #
# @$. . .$##
## $##$## #
 #    .   #
 ##########