           #
          # #
        ##   ##
        #  $  #
       #  $ $  #
     ## .$.$.$. ##
     # .$.$.$.$. #
    # .$.$.$.$.$. #
  ## .$.$.$.$.$.$. ##
  #  $.$.$. .$.$.$  #
 #  $.$.$.   .$.$.$  #
#  $ $.$.  @  .$.$ $  #
 #  $.$.$.   .$.$.$  #
  #  $.$.$. .$.$.$  #
  ## .$.$.$.$.$.$. ##
    # .$.$.$.$.$. #
     # .$.$.$.$. #
     ## .$.$.$. ##
       #  $ $  #
        #  $  #
        ##   ##
          # #
           #