difficulty:115
map
########
#......#
#  $ # ##
# $ # $ #
##$ $ $ #
 #    @ #
 ########