 #########################
##   #       #       #   ##
# #  .$.$.$.$ $.$.$.$.  # #
#   .$.$.$.$.$.$.$.$.$.   #
#  .$.$.$.$.$.$.$.$.$.$.  #
##.$.$.$.$.$.$.$.$.$.$.$.##
# $.$.$.$.$.$.$.$.$.$.$.$ #
# .$.$.$.$.$.$.$.$.$.$.$. #
# $.$.$.$.$.$.$.$.$.$.$.$ #
# .$.$.$.$.$.$.$.$.$.$.$. #
# $.$.$.$.$.$.$.$.$.$.$.$ #
# .$.$.$.$.     .$.$.$.$. #
# $.$.$.$.$  $  $.$.$.$.$ #
## $.$.$.$. $@$ .$.$.$.$ ##
# $.$.$.$.$  $  $.$.$.$.$ #
# .$.$.$.$.     .$.$.$.$. #
# $.$.$.$.$.$.$.$.$.$.$.$ #
# .$.$.$.$.$.$.$.$.$.$.$. #
# $.$.$.$.$.$.$.$.$.$.$.$ #
# .$.$.$.$.$.$.$.$.$.$.$. #
# $.$.$.$.$.$.$.$.$.$.$.$ #
##.$.$.$.$.$.$.$.$.$.$.$.##
#  .$.$.$.$.$.$.$.$.$.$.  #
#   .$.$.$.$.$.$.$.$.$.   #
# #  .$.$.$.$ $.$.$.$.  # #
##   #       #       #   ##
 #########################