    ##########
 #####   @ *#####
 ##  $$ ##. .  ##
 # #    ##    # #
##  # ##  ## #  ##
##.     ##     $##
#*  # #*##*# # $ #
# . # *    * #   #
# ## ## *  ## ## #
# ## ##  * ## ## #
#   # *    * # . #
# $ # #*##*# #  *#
##$     ##     .##
##  # ##  ## #  ##
 # #    ##    # #
 ##  . .## $$  ##
 #####*     #####
    ##########