85
  ##########
### ! .    #
#   ##$##  #
# @$. . .$##
## $##$## #
 #    .   #
 ##########