  #######
  ##  ###
### .$###
# $$.$ #
# . .  #
## $.$###
###$.$  #
  # . . #
  # .$$ #
 ###. ###
 ###@ ##
 ######