     ###########
    ##         ##
    #  #######  #
    # #       # #
    # # ##### # #
   ## #      $# ##
####  ##  ### .$ #
#    ###$ .....# #
# #$    $ $  # @ #
#   ###  #########
##### ####