        #####
        #   #####
   ###### #     ##
   #  ## * ####  ##
 ###       $   #  ###
 #   #####$#  $ #   #
 # $  $  #  $$# #   #
 ###.#..*......... ##
###    $#  # $ $ # #
# $ $## #### ####  #
# #  ##   @  #    ##
#  ##  ######  ####
##            ##
 ##############