  #####          ####
  #   ############..#
  #  $# $ $ $ $  $  #
  ## $  # # # #$  ..#
   #  # . . . *..   #
 ### $####@## # ## ##
## ## # ## ####$ ###
#   ..* . . . #  #
#..  $# # # #  $ ##
#  $  $ $ $ $ #$  #
#..############   #
####          #####