#####
#  @####
#  $.  #
###$.# #
#  $.# #
# #$.  #
#    ###
######