difficulty:82
map
#######
#..$..#
#..#..#
# $$$ #
#  $  #
# $$$ #
#  #@ #
#######