        #####
       ##   # #####
###### #  $ # #   ####
#    ### #$#### #    ##
#   ##   #  # $$ ###  #
#  ###  ##$ @ $     # #
#  #  . # $$ # $ $$ # #
#..#  .##   $#     ## #
#     . ##$  ####     #
#..##.#      #  #######
#     . #   ##
#..#  .  ####
#  ###.# #
#### #   #
     #####