          ####
          #  #
          #  #
          #  #
############ #
#    $ $.* $$#
# @  $..*.*. #
#   # *  $ .$#
#####*.$   *.#
    #.*   $.*#
    #$. $  * #####
    # .*.*..$#   #
    #$$ *.$ $    #
    # ############
    #  #
    #  #
    #  #
    ####