     ######
######    #
# $    $$ #
# $  ##   #
# $##  #$ #
# $ $$ #  #
# .....#$ #
##@#.#$ $ #
 #.....#$ #
 #...**#  #
 #  $    ##
 ####  ###
    ####