   ####
   #  #
   #$ #
   #  # ####
#### ####  #
#   .. ..  #
#  $*. *.$@##
#   #$ $#$  #
#####   #   #
    #########