250
    ######
    ##   #
    ##$  #
  ####  $##
  ##  $ $ #
#### # ## #   ######
##   # ## #####  ..#
## $  $          ..#
###### ### #@##  ..#
    ## @ ! #########
    ########