       #####
       #   #
      ## # #
      # *  #
      # # ##
####### #  #
#   # .$.$.####
# #   $$.$$   ###
#  *##..@..##*  #
###   $$.$$   # #
  ####.$.$. #   #
     #  # #######
     ## # #
     #  * #
     # # ##
     #   #
     #####