  ############
 #      @     #
# #  $ ## $  # #
#  #.##  ##.#  #
#  .   ##   .  #
# $# #*##*# #$ #
#  # *    * #  #
# # ## *  ## # #
# # ##  * ## # #
#  # *    * #  #
# $# #*##*# #$ #
#  .   ##   .  #
#  #.##  ##.#  #
# #  $ ## $  # #
 #            #
  ############