   #####
  #    ##  ######
 #  ##  # ##     #
 # #  # # #  ###  #
 # #  # ### #   # #
 # #  $  #  $   # #
 #  #$#*.#.*#$##  #
 ##   *.$ $.*    ##
  ### .$ . $. ####
    ### .#. ###
 #### .$ . $. ###
##    *.$@$.*   ##
#  ##$#*.#.*#$#  #
# #   $  #  $  # #
# #   # ### #  # #
#  ###  # # #  # #
 #     ## #  ##  #
  ######  ##    #
           #####