 #### # ####
##  #   #  ##
#   #####   #
#  $. * .$  #
###.$.$.$.###
  # .$ $. #
# #*$ @ $*# #
  # .$ $. #
###.$.$.$.###
#  $. * .$  #
#   #####   #
##  #   #  ##
 #### # ####