     #####
     #   #
    ## # #####
   ## *  #   #
  ### # ## # #####
###   $$# *  #   #
#  *#.  $ # ## # #
# #  *... $$# *  #
#   #$$ ....$ # #####
##### # $.+.. $$#   #
   #  * #$$ ...*  # #
   # # ## # $  .#*  #
   #   #  * #$$   ###
   ##### # ## # ###
       #   #  * ##
       ##### # ##
           #   #
           #####