    ######
    ##   #
    ##$  #
  ####  $##
  ##  $ $ #
#### # ## #   ######
##   # ## #####  ..#
## $  $          ..#
###### ### #@##  ..#
    ## @   #########
    ########