400
        ####
        #  #
        #  #
        #  #
########## #
#    $ $ $$#
# @  $..*. #
#   # *...$#
#####$...* #####
    # .*..$# @ #
    #$$ $ $    #
    # ##########
    #  #
    #  #
    #  #
    ####